border_size=1
usage=map

Aa^Fpa      , Aa^Fpa      , Aa^Fpa      , Aa^Fpa      , Ce          , Ce          , Ce          , Ce          , Ce          , Ce          , Ce          , Ce          , Ce          , Ce          , Ce          , Ce          , Ce          , Ce          , Ce          , Aa          , Aa          , Aa          
Aa^Fpa      , Aa^Fpa      , Aa^Fpa      , Aa^Fpa      , Aa^Fpa      , Aa          , Rr          , Aa          , Re^Gvs      , Re^Gvs      , Re^Gvs      , Re^Gvs      , Re          , Re          , Re^Gvs      , Re^Gvs      , Re^Gvs      , Re^Gvs      , Re^Gvs      , Ce          , Ce          , Aa          
Aa^Fpa      , Aa^Fpa      , Gs^Fp       , Gs^Fp       , Gs^Fp       , Rp          , Rp          , Rr          , Rr          , Re^Gvs      , Re          , Re          , Re^Gvs      , Gg^Vh       , Re^Gvs      , Re^Gvs      , Re^Gvs      , Re^Gvs      , Re^Gvs      , Re^Gvs      , Ce          , Aa          
Aa          , Aa          , Gs^Fp       , Gs^Fp       , Rp          , Rp          , Rp          , Rp          , Rr          , Rr          , Rr          , Re^Gvs      , Rp          , Re^Gvs      , Re^Gvs      , Re^Gvs      , Re^Gvs      , Re^Gvs      , Re^Gvs      , Re^Gvs      , Re^Gvs      , Ce          
Aa          , Aa          , Rp          , Rp          , Rp          , Rp          , Rp          , Rp          , Rr          , Rp          , Rp          , Rr          , Rp          , Rp          , Gg^Vh       , Re^Gvs      , Re^Gvs      , Re^Gvs      , Re^Gvs      , Re^Gvs      , Aa          , Ce          
Aa          , Aa          , Aa          , Aa          , Rp          , Rr          , Rr          , Gg^Vh       , Rr          , Rp          , Rp          , Rp          , Rp          , Rp          , Re          , Re          , Re^Gvs      , Re^Gvs      , Re^Gvs      , Re^Gvs      , Aa          , Ce          
Aa          , Aa          , Rp          , Rp          , Rp          , Rp          , Rp          , Rr          , Rr          , Gg^Vh       , Rp          , Rp          , Rp          , Rp          , Re          , Re          , Re          , Re^Gvs      , Re^Gvs      , Re^Gvs      , Aa          , Ce          
Ce          , Gg          , Rp          , Rp          , Rp          , Gg          , Gg          , Gg^Vh       , Rr          , Rr          , Rp          , Rp          , Rp          , Rp          , Re          , Re          , Re          , Re          , Re          , Aa          , Ce          , Ce          
Ce          , Gg          , Rp          , Rp          , Rp          , Gg          , Rp          , Rp          , Rr          , Gg^Ve       , Rp          , Rp          , Rp          , Ce          , 2 Ke        , Ce          , Re          , Re          , Rp          , Rp          , Ce          , Aa          
Ce          , Gg          , Rp          , Rp          , Rp          , Rp          , Rp          , Rp          , Rr          , Rp          , Rp          , Rp          , Gs          , Ce          , Ce          , Re          , Re          , Rp          , Rp          , Ce          , Gg          , Aa          
Ce          , Gg          , 3 Ke        , Ce          , Rp          , Rp          , Rp          , Rp          , Rr          , Rr          , Rp          , Gg^Vh       , Re          , Ce          , Gg^Fet      , Re          , Rp          , Rp          , Ce          , Ce          , Gg          , Aa          
Ce          , Gg          , Ggf         , Gg^Fet      , Gg^Vh       , Rp          , Rp          , Rr          , Rr          , Rp          , Rp          , Re          , Re          , Re          , Gg^Vh       , Rp          , Rp          , Ce          , Gg          , Gg          , Aa          , Aa          
Ce          , Gg          , Ww          , Ggf         , Ww          , Ggf         , Rp          , Rr          , Rr          , Rr          , Rp          , Gg^Vh       , Gs          , Gs          , Rp          , Rp          , Ce          , Ce          , Gg          , Aa          , Aa^Fpa      , Gs^Fp       
Ce          , Ggf         , Ww          , Ww          , Ww          , Ggf         , Rp          , Rp          , Rr          , Ai          , Rr          , Rp          , Rp          , Rp          , Rp          , Ce          , Ce          , Gg          , Gg          , Gg          , Gs^Fp       , Gs^Fp       
Ce          , Ggf         , Ai          , Ww          , Ww          , Ggf         , Rp          , Rp          , Rr          , Rr          , Gg^Vh       , Rr          , Rr          , Gg^Vh       , Rr          , Rr          , Rr          , Gg          , Gg          , Gg          , Gs^Fp       , Gs^Fp       
Ce          , Aa          , Aa          , Ai          , Ggf         , Ggf         , Rp          , Rp          , Rp          , Rp          , Rp          , Rp          , Rr          , Rr          , Ce          , Rr          , Rr          , Gg          , Gg          , Gg          , Gs^Fp       , Gs^Fp       
Ce          , Aa          , Rp          , Ggf         , Rp          , Rp          , Rp          , Rp          , Rp          , Rp          , Rp          , Rp          , Rp          , Rr          , Rr          , Rr          , Rr          , Re          , Re          , Gg          , Gg          , Gg          
Ce          , Aa          , Re^Gvs      , Rp          , Ce          , Ce          , Ce          , Gg^Vh       , Re          , Rp          , Rp          , Rp          , Ce          , Ce          , Gg          , Rr          , Re          , Rr          , Re          , Re          , Re          , Gg          
Ce          , Aa          , Re^Gvs      , Re^Gvs      , Re^Gvs      , 1 Ke        , Ce          , Re          , Rp          , Rp          , Ce          , Ce          , Gg          , Gg          , Gg          , Gg          , Gg          , Re          , Re          , Re          , Re          , Re          
Ce          , Aa          , Re^Gvs      , Re^Gvs      , Re^Gvs      , Re^Gvs      , Re          , Re          , Rp          , Rp          , Ce          , Ce          , Gg          , Gg          , Aa          , Aa          , Aa          , Gg          , Gg          , Re          , Re          , Re          
Ce          , Re^Gvs      , Re^Gvs      , Re^Gvs      , Re^Gvs      , Re^Gvs      , Re^Gvs      , Rp          , Ce          , Ce          , Gg          , Gg          , Gg          , Gg          , Aa^Fpa      , Aa^Fpa      , Aa^Fpa      , Aa          , Aa          , Gg          , Gg          , Re          
Ce          , Ce          , Ce          , Ce          , Ce          , Ce          , Ce          , Ce          , Aa          , Aa          , Aa          , Aa          , Aa          , Aa          , Aa          , Aa          , Aa          , Aa          , Aa          , Gg          , Gg          , Gg          
