border_size=1
usage=map

Xu          , Xu          , Xu          , Xu          , Xu          , Xu          , Xu          , Xu          , Xu          , Xu          , Uu          , Uu          , Uu          , Uu          , Uu          , Uu          , Uu          , Xu          , Xu          , Xu          , Xu          , Xu          
Xu          , Xu          , Xu          , Xu          , Xu          , Xu          , Xu          , Xu          , Xu          , Xu          , Uu          , Uu          , Uu          , Uu          , Rr          , Uu          , Uu          , Xu          , Xu          , Xu          , Xu          , Xu          
Xu          , Xu          , Xu          , Xu          , Xu          , Xu          , Xu          , Xu          , Xu          , Xu          , Uu          , Uu          , Uu          , Uu          , Rr          , Uu          , Xu          , Xu          , Xu          , Xu          , Xu          , Xu          
Xu          , Xu          , Xu          , Xu          , Xu          , Xu          , Xu          , Xu          , Xu          , Xu          , Xu          , Uu          , Ce          , 1 Ke        , Ce          , Uu          , Xu          , Xu          , Xu          , Xu          , Xu          , Xu          
Xu          , Xu          , Xu          , Xu          , Xu          , Xu          , Uu^Vu       , Xu          , Uu          , Uu^Vu       , Xu          , Xu          , Ce          , Ce          , Ce          , Xu          , Uu^Vu       , Xu          , Xu          , Xu          , Xu          , Xu          
Xu          , Xu          , Uu^Vu       , Xu          , Uu^Uf       , Uu          , Uu^Uf       , Uu          , Uu          , Uu          , Uu^Vu       , Xu          , Xu          , Ce          , Rr          , Xu          , Uu^Uf       , Uu^Uf       , Uu          , Xu          , Xu          , Xu          
Xu          , Xu          , Uh          , Uu          , Uu^Uf       , Uu^Uf       , Uh          , Uu^Uf       , Uu          , Uu          , Uu          , Xu          , Uu          , Uu          , Rr          , Xu          , Uu          , Uu^Uf       , Uh          , Uh          , Xu          , Xu          
Xu          , Xu          , Uh          , Uu^Uf       , Uu^Uf       , Uh          , Uu^Uf       , Uu^Uf       , Uu          , Uu          , Xu          , Xu          , Uu          , Rr          , Uu          , Uu          , Uu          , Uu          , Uh          , Uh          , Xu          , Xu          
Xu          , Xu          , Uh          , Uu          , Uu^Uf       , Uu^Uf       , Uu^Uf       , Uu          , Uu          , Uu^Vu       , Xu          , Xu          , Uu          , Rr          , Uu          , Uh          , Uh          , Uh          , Uu^Vu       , Uh          , Xu          , Xu          
Xu          , Xu          , Uu^Vu       , Uu          , Rr          , Uu^Uf       , Uu          , Uu          , Uu          , Xu          , Xu          , Uu          , Uu          , Uu          , Uu          , Uu          , Uu          , Uu          , Xu          , Xu          , Xu          , Xu          
Xu          , Xu          , Uu          , Uu          , Rr          , Uu^Uf       , Uu          , Uu          , Uu^Vu       , Xu          , Uu          , Uu          , Rr          , Uu          , Uu          , Uu          , Xu          , Xu          , Uu          , Uu^Vu       , Xu          , Xu          
Xu          , Xu          , Uu          , Uu          , Uu          , Uu          , Uu          , Uu          , Xu          , Xu          , Uu          , Uu          , Uu          , Uu          , Uu          , Uu          , Xu          , Xu          , Uu          , Uu          , Uu          , Uu          
Xu          , Xu          , Uu          , Uu          , Rr          , Uu          , Uu          , Uu          , Xu          , Uu          , Uu          , Uh          , Rr          , Uu          , Xu          , Xu          , Uu          , Uu          , Rr          , Uu          , Uu          , Uu          
Xu          , Xu          , Uu          , Uu          , Rr          , Uu          , Uu          , Uu          , Xu          , Uu          , Uh          , Uh          , Rr          , Uu          , Xu          , Uu^Vu       , Uu          , Rr          , Uu          , Rr          , Uu^Ii       , Uu          
Xu          , Xu          , Uu          , Uu          , Uu          , Rr          , Uu          , Xu          , Xu          , Uu          , Uu          , Uh          , Uu          , Uu          , Xu          , Uu          , Rr          , Rr          , Chr         , Uu          , Uu          , Uu          
Xu          , Xu          , Uu          , Uu          , Uu          , Rr          , Rr          , Uu          , Uu          , Uu          , Rr          , Rr          , Uu          , Xu          , Uu          , Uu          , Rr          , Uu          , Uu          , Uu          , Uu          , Uu          
Xu          , Xu          , Uu^Vu       , Uu          , Uu          , Uu          , Uh          , Rr          , Rr          , Chr         , Uu          , Uu          , Xu          , Xu          , Uu          , Rr          , Uu          , Uu          , Uu          , Uu          , Xu          , Uu          
Xu          , Xu          , Uu          , Uu          , Uu          , Uh          , Rr          , Uh          , Uu          , Uu          , Xu          , Xu          , Uu          , Uu          , Uu          , Rr          , Uu          , Uu          , Uu          , Uu          , Xu          , Xu          
Xu          , Xu          , Uu          , Uu          , Uu          , Uu          , Rr          , Uu          , Uu          , Xu          , Xu          , Uu          , Uu          , Uu          , Uu^Uf       , Rr          , Qxu         , Uu          , Uu          , Uu          , Xu          , Xu          
Xu          , Xu          , Uu          , Uu          , Uu^Vu       , Uu          , Rr          , Uu          , Uu          , Xu          , Uu          , Uu          , Uu^Uf       , Uu^Uf       , Rr          , Rr          , Qxu         , Qxu         , Uu          , Uu          , Xu          , Xu          
Xu          , Xu          , Uu          , Uu          , Uu          , Uu          , Uu          , Uu          , Xu          , Xu          , Uu          , Uu          , Uu          , Uu          , Uu          , Uu          , Uu          , Uu          , Uu          , Uu          , Xu          , Xu          
Xu          , Xu          , Uh          , Uu          , Uu          , Uu          , Rr          , Uu          , Xu          , Xu          , Uu          , Uu          , Rr          , Rr          , Xu          , Xu          , Uu^Uf       , Uu          , Uu          , Uu          , Xu          , Xu          
Qxu         , Xu          , Uh          , Uu          , Uu          , Uu          , Uu^Uf       , Uu          , Xu          , Xu          , Uu          , Uu          , Rr          , Uu          , Uu^Vu       , Xu          , Uu^Uf       , Uu^Uf       , Uu          , Uu          , Xu          , Xu          
Qxu         , Qxu         , Uh          , Uu          , Uu          , Uu^Uf       , Rr          , Uu          , Xu          , Xu          , Uu          , Uu          , Rr          , Uu          , Uu          , Uu          , Uu          , Uu          , Uu          , Uu          , Xu          , Xu          
Qxu         , Qxu         , Uh          , Uu          , Uu          , Uu          , Rr          , Uu          , Xu          , Xu          , Uu          , Uu          , Uu          , Uu          , Uu          , Uu          , Uu          , Uu          , Uu          , Uu          , Xu          , Xu          
Xu          , Qxu         , Uh          , Uu          , Uu          , Uu          , Rr          , Uu          , Xu          , Uu          , Uu          , Uu          , Rr          , Uu          , Uu          , Uu          , Uu          , Uu          , Uu          , Uu          , Xu          , Xu          
Xu          , Xu          , Uh          , Uu          , Uu          , Uu          , Uu^Uf       , Uu          , Xu          , Uu          , Uu          , Uu          , Rr          , Uu          , Uu          , Uu          , Uu          , Uu          , Xu          , Xu          , Xu          , Xu          
Xu          , Xu          , Uh          , Uu          , Uu          , Uu^Uf       , Uu          , Uu          , Xu          , Uu          , Uu          , Uu          , Rr          , Uu          , Uu          , Uu^Uf       , Uu^Uf       , Uu          , Xu          , Xu          , Xu          , Xu          
Xu          , Xu          , Uh          , Uu          , Uu          , Uu^Uf       , Rr          , Uu          , Xu          , Uu^Vu       , Uu          , Uu          , Uu          , Uu          , Uu          , Uu^Uf       , Uu^Uf       , Xu          , Xu          , Xu          , Xu          , Xu          
Xu          , Uh          , Uu          , Uu          , Uu          , Uu          , Rr          , Uu          , Uu          , Xu          , Uu          , Uu          , Rr          , Uu          , Uu          , Uu^Uf       , Uu^Uf       , Uu^Uf       , Uu          , Uu^Vu       , Xu          , Xu          
Xu          , Xu          , Uu          , Uu          , Uu          , Uu          , Rr          , Uu          , Uu          , Uu          , Rr          , Rr          , Uu          , Uu          , Uu          , Uu^Uf       , Uu^Uf       , Uu^Uf       , Uu^Uf       , Uu          , Xu          , Xu          
Xu          , Xu          , Uu          , Uu          , Xu          , Xu          , Rr          , Uu          , Uu^Uf       , Rr          , Uu          , Rr          , Uu          , Uu          , Uu          , Uu^Uf       , Uu^Uf       , Uu^Uf       , Uu^Uf       , Uu          , Xu          , Xu          
Xu          , Xu          , Uu          , Uu          , Uu^Vu       , Xu          , Rr          , Uu          , Uu          , Uu^Uf       , Uu          , Uu          , Rr          , Uu          , Uu          , Xu          , Xu          , Uu^Vu       , Uu          , Uu          , Xu          , Xu          
Xu          , Xu          , Uu          , Uu          , Uu          , Xu          , Rr          , Uu          , Uu          , Uu          , Xu          , Uu          , Uu          , Rr          , Uu          , Xu          , Uu^Vu       , Uu          , Uu          , Uu          , Xu          , Xu          
Xu          , Xu          , Uu          , Uu          , Uu          , Uu          , Rr          , Uu          , Uu          , Uu          , Xu          , Uu^Vu       , Uu          , Rr          , Uu          , Uu          , Uu          , Uu          , Uu          , Uu          , Xu          , Xu          
Xu          , Xu          , Uu          , Uu^Vu       , Uu          , Uu          , Uu          , Uu          , Uu          , Uu          , Xu          , Xu          , Uu          , Uu          , Uu          , Uu          , Chr         , Uu          , Uu          , Uu          , Xu          , Xu          
Xu          , Xu          , Uu          , Uu          , Uu^Uf       , Uu^Uf       , Uu^Uf       , Uu          , Uh          , Uu          , Xu          , Xu          , Uu          , Uu          , Chr         , Uu          , Chr         , Uu          , Chr         , Uu          , Xu          , Xu          
Xu          , Xu          , Uu          , Uu          , Uu^Vu       , Uu^Uf       , Uu          , Uh          , Uh          , Uh          , Xu          , Xu          , Uu          , Uu          , Uu          , Chr         , 2 Khr       , Chr         , Uu          , Uu          , Xu          , Xu          
Xu          , Xu          , Xu          , Uu          , Uu          , Uu          , Uu          , Uu          , Uu          , Uh          , Xu          , Uu^Vu       , Uu          , Uu          , Uu          , Uu          , Uu          , Uu          , Uu          , Uu          , Xu          , Xu          
Xu          , Xu          , Xu          , Xu          , Xu          , Uu          , Uu^Vu       , Uu          , Uu^Vu       , Uu          , Xu          , Xu          , Xu          , Xu          , Xu          , Xu          , Xu          , Xu          , Xu          , Uu^Vu       , Xu          , Xu          
Xu          , Xu          , Xu          , Xu          , Xu          , Xu          , Xu          , Xu          , Xu          , Xu          , Xu          , Xu          , Xu          , Xu          , Xu          , Xu          , Xu          , Xu          , Xu          , Xu          , Xu          , Xu          
Xu          , Xu          , Xu          , Xu          , Xu          , Xu          , Xu          , Xu          , Xu          , Xu          , Xu          , Xu          , Xu          , Xu          , Xu          , Xu          , Xu          , Xu          , Xu          , Xu          , Xu          , Xu          
