border_size=1
usage=map

Aa^Fpa      , Aa^Fpa      , Aa^Fpa      , Aa^Fpa      , Gs^Fp       , Gs^Fp       , Gs^Fp       , Gg          , Gg          , Gg          , Gg          , Gg          , Gg          , Gg          , Gg          , Aa^Vha      , Gg          , Gg          , Gg          , Ww          , Ww          , Re          , Re          , Re          , Chr         , Gs^Fp       , Mm          
Aa^Fpa      , Aa^Fpa      , Gs^Fp       , Gs^Fp       , Gs^Fp       , Gs^Fp       , Gg^Vh       , Gs^Fp       , Gs^Fp       , Gg          , Gs^Fp       , Gg          , Gg          , Gg          , Gg          , Gg          , Gg          , Gg          , Gs^Fp       , Ww          , Ww          , Re          , Re          , Re          , Chr         , Khr         , Mm          
Gs^Fp       , Gs^Fp       , Gs^Fp       , Gs^Fp       , Re^Gvs      , Re^Gvs      , Re^Gvs      , Re^Gvs      , Gg          , Gs^Fp       , Gg          , Gs^Fp       , Gg          , Gg          , Gg          , Gg          , Re^Gvs      , Gs^Fp       , Re^Gvs      , Ww          , Ww^Bw/      , Re          , Re          , Re          , Gg          , Chr         , Gs^Fp       
Gg          , Gs^Fp       , Re^Gvs      , Re^Gvs      , Re^Gvs      , Re^Gvs      , Re^Gvs      , Re^Gvs      , Gg          , Gg          , Gg          , Gg          , Gg          , Gg          , Gg          , Re^Gvs      , Re^Gvs      , Gg^Vh       , Re          , Ww^Bw/      , Ww          , Chr         , Re          , Re          , Gs^Fp       , Gs^Fp       , Gs^Fp       
Gg          , Gg          , Gg          , Gg          , Chr         , Gg          , Gg          , Gg          , Gg          , Chr         , Gg          , Gg          , Gg          , Gg          , Re^Gvs      , Re^Gvs      , Re          , Re          , Re          , Ww          , Ww          , Re          , Re          , Re          , Gg          , Gg          , Gs^Fp       
Gg          , Gg          , Gg          , Chr         , 1 Khr       , Chr         , Gg          , Gg          , Gg          , Chr         , Gg          , Gg          , Re          , Re          , Re          , Re          , Re          , Re          , Chr         , Ww          , Ww^Bw/      , Re          , Re^Gvs      , Gg          , Re^Gvs      , Hh          , Mm          
Gg          , Gg          , Gg          , Chr         , Chr         , Chr         , Gg          , Gg          , Re^Gvs      , Gg          , Re          , Re          , Re          , Re          , Re          , Re          , Re          , Re          , Re          , Ww^Bw/      , Ww          , Ww          , Re^Gvs      , Re^Gvs      , Gg^Vh       , Hh          , Mm          
Gg          , Gg          , Gg          , Gg          , Re^Gvs      , Gg          , Re^Gvs      , Re^Gvs      , Re^Gvs      , Gg^Vh       , Re          , Re          , Re          , Re          , Re          , Re          , Gg          , Gg          , Gg          , Gg          , Ww          , Ww          , Re^Gvs      , Re^Gvs      , Gs^Fp       , Gs^Fp       , Mm          
Gg          , Gg          , Gg          , Gg          , Re^Gvs      , Re^Gvs      , Re^Gvs      , Re^Gvs      , Re          , Re          , Re          , Re          , Re          , Re          , Re^Gvs      , Gg          , Gg          , Gg          , Gg          , Gg          , Ww          , Ww          , Gg          , Gs^Fp       , Gs^Fp       , Gs^Fp       , Mm          
Gg          , Gg          , Gg          , Chr         , Gg          , Chr         , Gg          , Re^Gvs      , Re          , Re          , Re          , Re          , Re^Gvs      , Re^Gvs      , Re^Gvs      , Re^Gvs      , Re^Gvs      , Gg          , Gg          , Gg          , Ww          , Ww          , Ds          , Gg          , Gg          , Hh          , Mm          
Gs^Fp       , Gs^Fp       , Gs^Fp       , Gg          , Gs^Fp       , Gg          , Gg          , Gg          , Re          , Re          , Re          , Gg^Vh       , Re^Gvs      , Re^Gvs      , Gg          , Re^Gvs      , Re^Gvs      , Re^Gvs      , Ds          , Ds          , Ww          , Ww          , Ds          , Gg          , Mm          , Mm          , Mm          
Gs^Fp       , Gs^Fp       , Gs^Fp       , Gs^Fp       , Gs^Fp       , Gs^Fp       , Gs^Fp       , Gs^Fp       , Re          , Re          , Re          , Re^Gvs      , Gs^Fp       , Gg          , Gg          , Re^Gvs      , Re^Gvs      , Gg^Vh       , Ds          , Ww          , Ww          , Ww          , Mm          , Mm          , Mm          , Mm          , Mm          
Gs^Fp       , Gs^Fp       , Gs^Fp       , Gs^Fp       , Gs^Fp       , Gg          , Gg          , Gg          , Re          , Re          , Re          , Gs^Fp       , Gg          , Gs^Fp       , Gs^Fp       , Gg          , Gg          , Ds          , Ww          , Ww          , Ww          , Ds          , Mm          , Mm          , Mm          , Mm          , Mm          
Gs^Fp       , Gs^Fp       , Gg          , Gg          , Gg^Fet      , Gg          , Gg          , Gg          , Re          , Re          , Re          , Gs^Fp       , Gs^Fp       , Gs^Fp       , Gs^Fp       , Gs^Fp       , Gs^Fp       , Ds          , Ww          , Ww          , Ww          , Ds          , Mm          , Mm          , Mm          , Mm          , Mm          
Gs^Fp       , Gg          , Gg          , Gg          , Gs^Fp       , Gg          , Gg          , Gg          , Re          , Re          , Re          , Gg          , Gs^Fp       , Gs^Fp       , Ggf         , Gs^Fp       , Gs^Fp       , Ds          , Ds          , Ww          , Ww          , Ds          , Ds          , Mm          , Hh          , Mm          , Mm          
Gs^Fp       , Gg^Ve       , Gg^Fet      , Gg          , Ggf         , Gs^Fp       , Gs^Fp       , Gs^Fp       , Re          , Re          , Re          , Gs^Fp       , Gg          , Gs^Fp       , Gg^Ve       , Ggf         , Gs^Fp       , Gg          , Ds          , Ww          , Ww          , Ww          , Ds          , Gs          , Hh          , Hh          , Mm          
Gs^Fp       , Gs^Fp       , Gs^Fp       , Ggf         , Gs^Fp       , Ggf         , Gs^Fp       , Gs^Fp       , Re          , Re          , Re          , Re          , Re          , Gg          , Gs^Fp       , Gg^Fet      , Gs^Fp       , Gs^Fp       , Gs^Fp       , Ds          , Ww          , Ww          , Ds          , Gs          , Hh          , Mm          , Mm          
Gs^Fp       , Gs^Fp       , Gs^Fp       , Gs^Fp       , Gs^Fp       , Gs^Fp       , Gs^Fp       , Gs^Fp       , Gs^Fp       , Re          , Re          , Re          , Re          , Re          , Gs^Fp       , Gs^Fp       , Gs^Fp       , Gs^Fp       , Gs^Fp       , Ds          , Ww          , Ww          , Ds          , Gs          , Hh          , Mm          , Mm          
Gs^Fp       , Cv          , Gs^Fp       , Gs^Fp       , Gs^Fp       , Cv          , Gs^Fp       , Gs^Fp       , Gs^Fp       , Cv          , Re          , Re          , Re          , Cv          , Re          , Gs^Fp       , Gs^Fp       , Cv          , Gs          , Ds          , Ww          , Ww          , Ds          , Gs          , Hh          , Hh          , Mm          
Gs^Fp       , Gs^Fp       , Gs^Fp       , Gs^Fp       , Gs^Fp       , Gs^Fp       , Gs^Fp       , Gs^Fp       , Gs^Fp       , Gs^Fp       , Gs^Fp       , Re          , Re          , Re          , Re          , Re          , Gs^Fp       , Gs^Fp       , Gs          , Ds          , Ww          , Ww          , Ds          , Gs          , Gs^Fp       , Gs^Fp       , Mm          
Gs^Fp       , Gs^Fp       , Gs^Fp       , Gs^Fp       , Gs^Fp       , Gs^Fp       , Gg^Fet      , Gs^Fp       , Gs^Fp       , Gs^Fp       , Gs^Fp       , Gs^Fp       , Gs^Fp       , Re          , Re          , Re          , Re          , Gs^Fp       , Gs          , Ds          , Ww          , Ww          , Ds          , Gs          , Gs          , Gs^Fp       , Mm          
Gs^Fp       , Gg^Fet      , Gs^Fp       , Gs^Fp       , Gs^Fp       , Gs^Fp       , Gs^Fp       , Gs^Fp       , Gs^Fp       , Gs^Fp       , Gg^Fet      , Gs^Fp       , Gs^Fp       , Gg^Ve       , Re          , Re          , Re          , Gs^Fp       , Gs          , Ds          , Ww          , Ww          , Ww          , Ds          , Gs^Ft       , Gs^Fp       , Mm          
Gs^Fp       , Gs^Fp       , Gs^Fp       , Gs^Fp       , Gs^Fp       , Gs^Fp       , Gs^Fp       , Gs^Fp       , Gs^Fp       , Gs^Fp       , Gs^Fp       , Gs^Fp       , Gs^Fp       , Gs^Fp       , Re          , Re          , Re          , Gs^Fp       , Gs          , Ds          , Ww          , Ww          , Ww          , Ds          , Gs          , Gs^Fp       , Mm          
Gs^Fp       , Gs^Fp       , Gs^Fp       , Gs^Fp       , Cv          , Cv          , Cv          , Gs^Fp       , Gs^Fp       , Gs^Fp       , Gs^Fp       , Gs^Fp       , Gs^Fp       , Gs^Fp       , Re          , Re          , Re          , Gs^Fp       , Gs^Ft       , Ds          , Ww          , Ww          , Ww          , Ds          , Gs          , Hh          , Mm          
Gs^Fp       , Gs^Fp       , Gs^Fp       , Gs^Fp       , Gs^Fp       , 2 Kv        , Ggf         , Ggf         , Ggf         , Gs^Fp       , Gs^Fp       , Gs^Fp       , Gs^Fp       , Gs^Fp       , Re          , Re          , Re          , Gs^Fp       , Gs^Fp       , Gs          , Gs^Ft       , Ww          , Ww          , Ds          , Gs          , Hh          , Mm          
Gs^Fp       , Gs^Fp       , Gg^Fet      , Gs^Fp       , Gs^Fp       , Gs^Fp       , Gg^Ve       , Ggf         , Ggf         , Gg^Ve       , Gs^Fp       , Gs^Ft       , Gs^Fp       , Gs^Fp       , Re          , Re          , Re          , Gs^Fp       , Gs^Fp       , Gs          , Ds          , Ww          , Ww          , Ds          , Gs^Ft       , Hh          , Mm          
Gs^Ft       , Gs^Fp       , Gs^Fp       , Gs^Fp       , Gs^Fp       , Gs^Fp       , Gs^Fp       , Gs^Fp       , Gs^Fp       , Gs^Fp       , Gs^Fp       , Gs^Fp       , Gs^Fp       , Gs^Fp       , Re          , Re          , Re          , Gg^Fet      , Gs^Fp       , Gs          , Ds          , Ww          , Ww          , Ds          , Gs          , Hh          , Mm          
