border_size=1
usage=map

Xu          , Xu          , Xu          , Xu          , Xu          , Xu          , Xu          , Xu          , Xu          , Xu          , Xu          , Xu          
Xu          , Xu          , Xu          , Xu          , Xu          , Xu          , Xu          , Xu          , Xu          , Xu          , Xu          , Xu          
Xu          , Xu          , Xu          , Xu          , Xu          , Xu          , Xu          , Xu          , Xu          , Xu          , Xu          , Xu          
Xu          , Xu          , Xu          , Xu          , Re          , Xu          , Re          , Xu          , Re          , Xu          , Xu          , Xu          
Xu          , Xu          , Xu          , Xu          , Re          , Re          , Ce          , Re          , Re          , Xu          , Xu          , Xu          
Xu          , Xu          , Xu          , Xu          , Re          , Ds          , Ds          , Ds          , Re          , Xu          , Xu          , Xu          
Xu          , Xu          , Xu          , Xu          , Re          , Ds          , Ds          , Ds          , Re          , Xu          , Xu          , Xu          
Xu          , Xu          , Xu          , Xu          , Re          , Ds          , Ce          , Ds          , Re          , Xu          , Xu          , Xu          
Xu          , Xu          , Xu          , Xu          , Xu          , Re          , 1 Ke        , Re          , Re          , Xu          , Xu          , Xu          
Xu          , Xu          , Xu          , Xu          , Xu          , Re          , Re          , Re          , Xu          , Xu          , Xu          , Xu          
Xu          , Xu          , Xu          , Xu          , Xu          , Re          , Xu          , Re          , Xu          , Xu          , Xu          , Xu          
Xu          , Xu          , Xu          , Xu          , Xu          , Xu          , Xu          , Xu          , Xu          , Xu          , Xu          , Xu          
