border_size=1
usage=map

Mm^Xm       , Mm^Xm       , Mm^Xm       , Mm^Xm       , Mm^Xm       , Mm^Xm       , Mm^Xm       , Mm^Xm       , Mm^Xm       , Mm^Xm       , Mm^Xm       , Mm^Xm       , Mm^Xm       , Mm^Xm       , Mm^Xm       , Mm^Xm       , Mm^Xm       , Mm^Xm       , Mm^Xm       , Mm^Xm       , Mm^Xm       , Mm^Xm       , Mm^Xm       , Mm^Xm       , Mm^Xm       , Mm^Xm       , Mm^Xm       , Mm^Xm       , Mm^Xm       , Ha          , Ha          , Ha          , Ha          , Ha          , Ha          , Ha          , Ha          , Ha          , Ha          , Ha          , Mm^Xm       , Mm^Xm       
Mm^Xm       , Mm^Xm       , Mm^Xm       , Mm^Xm       , Mm^Xm       , Mm^Xm       , Mm^Xm       , Mm^Xm       , Ha          , Ha          , Ha          , Ha          , Ha          , Ha          , Ha          , Aa^Fpa      , Ha          , Ha          , Mm^Xm       , Mm^Xm       , Ha          , Ha          , Aa^Fpa      , Ha          , Aa^Fpa      , Ha          , Aa^Fpa      , Ha          , Ha          , Ha          , Ha          , Ha          , Ha          , Ha          , Ha          , Ha          , Ha          , Ha          , Ha          , Mm^Xm       , Mm^Xm       , Mm^Xm       
Mm^Xm       , Mm^Xm       , Mm^Xm       , Mm^Xm       , Mm^Xm       , Mm^Xm       , Mm^Xm       , Mm^Xm       , Mm^Xm       , Ha          , Aa          , Aa          , Re          , Aa          , Aa          , Aa^Fpa      , Aa^Fpa      , Ha          , Mm^Xm       , Mm^Xm       , Mm^Xm       , Aa^Fpa      , Aa^Fpa      , Aa^Fpa      , Aa^Fpa      , Aa^Fpa      , Aa^Fpa      , Ha          , Ha          , Ha          , Ha          , Ha          , Ha          , Ha          , Ha          , Ha          , Ha          , Ha          , Ha          , Mm^Xm       , Mm^Xm       , Mm^Xm       
Mm^Xm       , Mm^Xm       , Mm^Xm       , Mm^Xm       , Qlf         , Qlf         , Qlf         , Mm^Xm       , Mm^Xm       , Mm^Xm       , Re          , Aa          , Re          , Aa          , Aa          , Aa          , Aa^Fpa      , Mm^Xm       , Mm^Xm       , Mm^Xm       , Re          , Aa^Fpa      , Aa          , Aa          , Re          , Aa          , Aa          , Aa^Fpa      , Aa^Fpa      , Aa^Fpa      , Aa^Fpa      , Aa^Fpa      , Aa^Fpa      , Ha          , Ha          , Ha          , Ha          , Ha          , Ha          , Ha          , Ha          , Ha          
Mm^Xm       , Mm^Xm       , Mm^Xm       , Mm^Xm       , Mm^Xm       , Qlf         , Mm^Xm       , Mm^Xm       , Mm^Xm       , Re          , Aa^Fpa      , Re          , Re          , Re          , Re          , Re          , Re          , Ha          , Ha          , Ha          , Mm^Xm       , Re          , Re          , Re          , Re          , Re          , Re          , Aa          , Re          , Aa          , Aa          , Aa^Fpa      , Aa          , Aa^Fpa      , Aa^Fpa      , Ha          , Aa^Fpa      , Ha          , Aa^Fpa      , Ha          , Ha          , Ha          
Ha          , Ha          , Ha          , Mm^Xm       , Mm^Xm       , Mm^Xm       , Mm^Xm       , Mm^Xm       , Aa^Fpa      , Aa^Fpa      , Ha          , Aa^Fpa      , Re          , Re          , Aa          , Aa          , Aa^Fpa      , Mm^Xm       , Mm^Xm       , Mm^Xm       , Ha          , Ha          , Ha          , Aa          , Aa          , Re          , Re          , Re          , Re          , Re          , Re          , Aa          , Aa          , Aa          , Aa          , Aa          , Aa          , Aa^Fpa      , Aa^Fpa      , Ha          , Ha          , Ha          
Ha          , Ha          , Ha          , Aa          , Aa          , Mm^Xm       , Mm^Xm       , Mm^Xm       , Aa^Fpa      , Ha          , Ha          , Aa^Fpa      , Re          , Aa          , Aa          , Aa          , Aa^Fpa      , Ha          , Mm^Xm       , Ha          , Ha          , Ha          , Aa          , Aa          , Aa          , Aa^Fpa      , Aa^Fpa      , Re          , Ha          , Aa          , Aa          , Re          , Re          , Re          , Re          , Aa          , Aa          , Aa^Fpa      , Aa^Fpa      , Ha          , Ha          , Ha          
Ha          , Ha          , Ha          , Aa^Fpa      , Aa^Fpa      , Aa          , Aa          , Aa          , Aa^Fpa      , Ha          , Aa^Fpa      , Aa^Fpa      , Re          , Aa          , Aa          , Aa          , Aa^Fpa      , Ha          , Mm^Xm       , Mm^Xm       , Ha          , Aa^Fpa      , Aa          , Aa          , Aa          , Aa^Fpa      , Aa^Fpa      , Aa^Fpa      , Ha          , Ha          , Aa          , Aa          , Aa          , Re          , Re          , Re          , Aa          , Aa^Fpa      , Aa^Fpa      , Ha          , Ha          , Ha          
Ha          , Ha          , Ha          , Aa^Fpa      , Aa^Fpa      , Aa          , Aa          , Aa          , Aa^Fpa      , Aa^Fpa      , Aa^Fpa      , Aa          , Re          , Aa          , Aa          , Aa^Fpa      , Aa^Fpa      , Ha          , Mm^Xm       , Mm^Xm       , Ha          , Aa^Fpa      , Aa          , Aa          , Aa          , Aa          , Aa          , Aa^Fpa      , Ha          , Ha          , Ha          , Aa          , Aa          , Aa          , Re          , Re          , Aa          , Aa          , Aa^Fpa      , Ha          , Ha          , Ha          
Ha          , Ha          , Ha          , Aa^Fpa      , Aa^Fpa      , Aa          , Aa          , Aa          , Aa          , Aa          , Aa^Fpa      , Aa          , Re          , Aa          , Aa          , Aa^Fpa      , Ha          , Ha          , Mm^Xm       , Mm^Xm       , Ha          , Aa^Fpa      , Aa          , Aa          , Aa          , Aa          , Aa          , Aa          , Ha          , Ha          , Ha          , Aa          , Aa^Fpa      , Aa          , Re          , Re          , Aa          , Aa          , Aa^Fpa      , Ha          , Ha          , Ha          
Ha          , Ha          , Ha          , Aa^Fpa      , Aa          , Aa          , Aa          , Aa          , Aa          , Aa          , Aa^Fpa      , Ha          , Re          , Aa          , Aa          , Aa^Fpa      , Ha          , Ha          , Mm^Xm       , Mm^Xm       , Aa^Fpa      , Aa^Fpa      , Aa          , Aa          , Aa^Fpa      , Aa          , Aa          , Aa          , Aa          , Ha          , Ha          , Aa^Fpa      , Aa^Fpa      , Aa^Fpa      , Re          , Aa^Fpa      , Aa          , Aa          , Aa          , Ha          , Ha          , Ha          
Ha          , Ha          , Ha          , Aa          , Aa          , Aa          , Aa          , Aa          , Aa          , Aa          , Re          , Re          , Aa^Fpa      , Aa          , Aa          , Aa^Fpa      , Aa^Fpa      , Ha          , Ha          , Mm^Xm       , Aa^Fpa      , Aa          , Aa          , Aa          , Aa^Fpa      , Ai          , Ai          , Aa          , Aa          , Aa          , Ha          , Ha          , Ha          , Aa^Fpa      , Re          , Re          , Aa          , Aa          , Aa          , Ha          , Ha          , Ha          
Ha          , Ha          , Ha          , Aa          , Ai          , Ai          , Aa^Fpa      , Aa          , Re          , Re          , Aa          , Aa^Fpa      , Aa          , Aa          , Aa          , Aa^Fpa      , Ha          , Ha          , Mm^Xm       , Mm^Xm       , Aa^Fpa      , Aa          , Aa          , Aa          , Aa^Fpa      , Ai          , Ai          , Ai          , Aa          , Aa          , Ha          , Ha          , Aa          , Re          , Re          , Aa          , Aa          , Aa          , Aa^Fpa      , Ha          , Ha          , Ha          
Ha          , Ha          , Ha          , Aa          , Ai          , Ai          , Re          , Re          , Aa^Fpa      , Aa          , Aa          , Aa          , Aa          , Aa          , Aa          , Aa          , Ha          , Ha          , Mm^Xm       , Mm^Xm       , Ha          , Aa          , Aa          , Aa          , Aa          , Aa^Fpa      , Aa          , Aa          , Aa          , Aa          , Ha          , Ha          , Aa          , Re          , Re          , Aa          , Aa          , Aa          , Aa^Fpa      , Ha          , Ha          , Ha          
Ha          , Ha          , Ha          , Aa          , Aa^Fpa      , Re          , Ai          , Ai          , Ai          , Aa          , Aa          , Aa          , Aa          , Aa          , Aa^Fpa      , Aa^Fpa      , Aa^Fpa      , Ha          , Mm^Xm       , Mm^Xm       , Ha          , Ha          , Ha          , Aa^Fpa      , Aa^Fpa      , Aa          , Aa          , Aa          , Aa          , Aa^Fpa      , Ha          , Ha          , Aa          , Re          , Re          , Aa          , Aa          , Aa^Fpa      , Ai          , Ha          , Ha          , Ha          
Ha          , Ha          , Ha          , Aa^Fpa      , Re          , Re          , Ai          , Ai          , Aa          , Aa          , Ha          , Ha          , Ha          , Aa^Fpa      , Aa^Fpa      , Aa^Fpa      , Aa^Fpa      , Ha          , Mm^Xm       , Mm^Xm       , Ha          , Ha          , Ha          , Ha          , Ha          , Aa^Fpa      , Aa^Fpa      , Aa          , Aa^Fpa      , Aa^Fpa      , Ha          , Aa          , Aa          , Re          , Aa          , Aa          , Ai          , Ai          , Wo          , Ai          , Ai          , Ha          
Ha          , Ha          , Ha          , Aa^Fpa      , Re          , Ai          , Aa          , Aa          , Aa^Fpa      , Aa^Fpa      , Ha          , Ha          , Ha          , Ha          , Ha          , Ha          , Ha          , Mm^Xm       , Mm^Xm       , Mm^Xm       , Mm^Xm       , Ha          , Ha          , Ha          , Ha          , Ha          , Aa^Fpa      , Aa^Fpa      , Ha          , Ha          , Aa          , Aa          , Re          , Re          , Aa          , Ai          , Ai          , Wo          , Wo          , Ai          , Ai          , Ha          
Ha          , Ha          , Ha          , Aa^Vea      , Re          , Aa          , Aa          , Aa          , Aa          , Aa^Fpa      , Aa^Fpa      , Ha          , Ha          , Ha          , Ha          , Ha          , Mm^Xm       , Mm^Xm       , Mm^Xm       , Mm^Xm       , Mm^Xm       , Ha          , Ha          , Ha          , Ha          , Ha          , Ha          , Ha          , Aa          , Ha          , Aa          , Aa          , Re          , Re          , Re          , Aa          , Aa          , Ai          , Ai          , Ai          , Ai          , Ha          
Ha          , Ha          , Ha          , Aa^Fpa      , Re          , Aa^Fpa      , Aa^Fpa      , Aa^Fpa      , Aa^Fpa      , Aa^Fpa      , Aa^Fpa      , Ha          , Ha          , Ha          , Ha          , Ha          , Mm^Xm       , Ha          , Ha          , Mm^Xm       , Ha          , Ha          , Ha          , Ha          , Aa^Fpa      , Aa^Fpa      , Aa          , Aa          , Aa          , Aa          , Aa          , Aa          , Aa          , Re          , Re          , Re          , Re          , Aa          , Aa          , Ai          , Ai          , Ha          
Ha          , Ha          , Aa^Fpa      , Re          , Aa^Fpa      , Aa^Fpa      , Ha          , Aa^Fpa      , Ha          , Aa^Fpa      , Mm^Xm       , Ha          , Mm^Xm       , Ha          , Ha          , Mm^Xm       , Ha          , Ha          , Ha          , Ha          , Ha          , Ha          , Ha          , Ha          , Ha          , Aa^Fpa      , Aa^Fpa      , Aa          , Aa^Fpa      , Aa          , Aa^Fpa      , Aa^Fpa      , Aa^Fpa      , Aa          , Aa          , Aa          , Ha          , 1 Re        , Re          , Ai          , Ha          , Ha          
Mm^Xm       , Aa^Fpa      , Aa^Fpa      , Re          , Aa^Fpa      , Ha          , Mm^Xm       , Ha          , Mm^Xm       , Mm^Xm       , Mm^Xm       , Mm^Xm       , Mm^Xm       , Mm^Xm       , Mm^Xm       , Mm^Xm       , Mm^Xm       , Ha          , Ha          , Ha          , Ha          , Ha          , Ha          , Ha          , Ha          , Ha          , Ha          , Aa^Fpa      , Ha          , Aa^Fpa      , Ha          , Ha          , Ha          , Ha          , Ha          , Ha          , Ha          , 2 Re        , Ha          , Ha          , Ha          , Ha          
Mm^Xm       , Aa^Fpa      , Aa^Fpa      , Re          , Aa^Fpa      , Mm^Xm       , Mm^Xm       , Mm^Xm       , Mm^Xm       , Mm^Xm       , Mm^Xm       , Mm^Xm       , Mm^Xm       , Mm^Xm       , Mm^Xm       , Mm^Xm       , Mm^Xm       , Ha          , Ha          , Ha          , Ha          , Ha          , Ha          , Ha          , Ha          , Ha          , Ha          , Ha          , Ha          , Ha          , Ha          , Ha          , Ha          , Ha          , Ha          , Ha          , Ha          , Ha          , Ha          , Ha          , Ha          , Ha          
