border_size=1
usage=map

Ha          , Ha          , Ha          , Aa          , Aa          , Aa          , Aa^Fpa      , Re          , Re          , Aa          , Aa          , Aa          , Aa          , Aa          , Aa          , Aa          , Aa          , Aa          , Mm^Xm       , Mm^Xm       , Mm^Xm       , Mm^Xm       
Ha          , Ha          , Ha          , Aa          , Aa          , Aa          , Aa^Fpa      , Re          , Re          , Aa          , Aa          , Aa          , Aa          , Aa          , Aa          , Aa          , Aa          , Aa          , Ha          , Mm^Xm       , Mm^Xm       , Mm^Xm       
Ha          , Aa          , Aa          , Aa          , Aa          , Aa^Fpa      , Aa^Fpa      , Re          , Re          , Aa^Fpa      , Aa          , Aa          , Aa          , Aa          , Aa          , Aa          , Aa          , Aa          , Ha          , Mm^Xm       , Mm^Xm       , Mm^Xm       
Ha          , Ha          , Aa          , Aa          , Aa          , Aa          , Aa          , Re          , Re          , Aa          , Aa          , Aa          , Aa          , Aa          , Aa          , Aa          , Aa          , Aa          , Ha          , Mm          , Mm^Xm       , Mm^Xm       
Ha          , Aa          , Aa          , Aa          , Aa          , Aa          , Aa          , Re          , Re          , Aa          , Aa          , Aa          , Aa          , Aa          , Aa          , Aa          , Aa          , Aa          , Ha          , Mm          , Mm^Xm       , Mm^Xm       
Ha          , Aa          , Aa          , Aa          , Aa          , Aa          , Aa          , Re          , Ce          , Aa          , Aa          , Aa          , Aa          , Aa          , Aa          , Aa          , Aa          , Aa          , Ha          , Ha          , Mm^Xm       , Mm^Xm       
Ha          , Aa          , Aa          , Aa          , Aa          , Aa          , Aa          , Re          , Re          , Aa^Fpa      , Aa          , Aa          , Aa          , Aa          , Aa          , Aa          , Aa          , Aa          , Ha          , Ha          , Mm^Xm       , Mm^Xm       
Ha          , Aa          , Aa          , Aa          , Aa          , Aa          , Aa          , Re          , Re          , Aa^Fpa      , Aa          , Aa          , Aa          , Aa          , Aa          , Aa          , Aa          , Aa          , Ha          , Ha          , Mm^Xm       , Mm^Xm       
Ha          , Ha          , Aa          , Aa          , Aa          , Aa          , Aa          , Re          , Re          , Aa^Fpa      , Aa          , Aa          , Aa          , Aa          , Aa          , Aa^Vha      , Aa^Fpa      , Aa^Fpa      , Ha          , Ha          , Mm^Xm       , Mm^Xm       
Ha          , Aa          , Aa          , Aa          , Aa          , Aa          , Aa          , Re          , Re          , Re          , Re          , Aa          , Aa          , Aa          , Aa          , Aa          , Aa          , Aa^Fpa      , Ha          , Ha          , Mm^Xm       , Mm^Xm       
Ha          , Aa          , Aa          , Aa          , Aa          , Aa          , Aa^Fpa      , Aa^Fpa      , Re          , Re          , Re          , Aa^Fpa      , Aa^Fpa      , Aa          , Aa          , Aa          , Aa          , Aa^Fpa      , Aa^Fpa      , Ha          , Mm^Xm       , Mm^Xm       
Ha          , Aa^Fpa      , Aa          , Aa          , Aa          , Aa^Fpa      , Aa^Fpa      , Ha          , Ha          , Re          , Re          , Re          , Ha          , Aa^Fpa      , Aa^Fpa      , Aa          , Aa          , Aa^Fpa      , Aa^Fpa      , Ha          , Ha          , Mm^Xm       
Ha          , Aa^Fpa      , Aa^Fpa      , Aa          , Aa          , Aa          , Aa          , Aa^Fpa      , Aa^Fpa      , Ha          , Re          , Re          , Re          , Ha          , Aa^Fpa      , Aa^Fpa      , Aa          , Aa          , Ha          , Ha          , Aa          , Aa          
Ha          , Aa^Fpa      , Aa          , Aa          , Aa          , Aa          , Aa          , Aa          , Aa          , Aa^Fpa      , Aa^Fpa      , Re          , Re          , Re          , Aa^Fpa      , Aa^Fpa      , Aa          , Aa          , Aa          , Ha          , Aa          , Aa          
Ha          , Ha          , Aa          , Aa          , Aa^Vha      , Gg          , Hh          , Aa          , Aa          , Aa^Fpa      , Aa^Fpa      , Re          , Re          , Re          , Re          , Aa          , Aa          , Aa          , Aa          , Ha          , Aa          , Aa          
Ha          , Ha          , Aa          , Aa          , Ai          , Ww          , Ww          , Hh          , Gg          , Aa          , Aa          , Aa          , Aa          , Re          , Re          , Re          , Re          , Aa          , Aa          , Aa          , Aa          , Aa          
Ha          , Aa^Fpa      , Aa          , Aa          , Ai          , Ai          , Ai          , Gg          , Gg          , Gg          , Aa          , Aa          , Aa          , Aa          , Aa          , Re          , Re          , Re          , Re          , Aa          , Aa          , Aa          
Ha          , Aa^Fpa      , Aa          , Aa          , Aa          , Ai          , Aa          , Aa          , Gs^Fp       , Gg          , Gs^Fp       , Aa          , Aa          , Aa          , Aa          , Aa          , Aa          , Re          , Re          , Ce          , Ce          , Aa          
Ha          , Aa^Fpa      , Aa          , Aa          , Aa          , Aa          , Aa          , Aa          , Aa^Fpa      , Hh          , Ha          , Aa          , Aa          , Aa          , Aa          , Aa          , Aa          , Gg          , Gg          , Ce          , 1 Ke        , Re          
Ha          , Aa^Fpa      , Aa^Fpa      , Aa          , Aa          , Aa          , Aa          , Aa          , Aa          , Ha          , Ha^Vhha     , Aa          , Aa          , Aa          , Aa          , Aa          , Gg          , Gg          , Gg          , Ce          , Gg          , Gg          
Ha          , Ha          , Ha          , Aa^Fpa      , Aa^Fpa      , Aa^Fpa      , Aa          , Aa          , Aa          , Ha          , Ha          , Ha          , Aa          , Aa          , Aa          , Gg          , Gg          , Gg          , Gg          , Gg          , Gg          , Gg          
Ha          , Ha          , Ha          , Ha          , Ha          , Aa^Fpa      , Aa^Fpa      , Aa^Fpa      , Aa^Fpa      , Aa^Fpa      , Ha          , Ha          , Aa^Fpa      , Aa^Fpa      , Aa^Fpa      , Gs^Fp       , Gg          , Gg          , Gg          , Gg          , Gg          , Gg          
